XEXXXXXXXXXXXXXXXXXXXXXXX
X1X_X___X___X_X_____X__#X
X_X___X___X_X_X_X_X_X_X_X
X_X_X_XXXXXXX_X_X_X_X_X_X
X_X_X_X_______X_X_X_X___X
X_X_X_X_X_XXX___X_X_X_XXX
X_X_X_X___X_XXX_XXX___X_X
X_XXX_X_X_X_X@X_X_X_X_X_X
X_X___X_X___X_XXX_X_X_X_X
X___X_X_X_X_X___X_X_X_X_X
XXXXX_X_XXX_X_X_X_X_X_X_X
X___X___X_X_X_X_X_______X
X_X_X_X_X_X___X_X_X_X_XDX
X!X2__X___X_X_____X_XCXPX
XXXXXXXXXXXXXXXXXXXXXXXXX
