XXXXXXXXXXXX
XCX_X____X!X
X_X_X_XX___X
X_X___X@X_XX
X__XX_X_X__X
X_X___X_XX_X
X____X_____X
X__X___X_XXX
X_X#X_X____X
X_X_X_X_XXDX
X___X1X__XPX
XXXXXEXXXXXX